#Roadkill
MYS = "countries/R-Mystery Shack.txt"
GTF = "countries/R-Gravity Falls.txt"
NRW = "countries/R-Northwest.txt"
GNM = "countries/R-Gnome Kingdom.txt"
UFC = "countries/R-Multibears.txt"
UNI = "countries/R-Unicorns.txt"
MAN = "countries/R-Manotaurs Lands.txt"
GID = "countries/R-Tent of Telepathy.txt"
CRL = "countries/R-Crawlspace.txt"

#Tourist
MYM = "countries/T-Mystery Mountain.txt"
YBL = "countries/T-Upside Down.txt"
UPD = "countries/T-Yarnball.txt"
LOG = "countries/T-Logland.txt"
COR = "countries/T-Cornmaze.txt"

#Earth
ORE = "countries/E-Oregon.txt"
CAL = "countries/E-California.txt"
WAS = "countries/E-Washington.txt"
MCA = "countries/E-Middle California.txt"
SOC = "countries/E-Southern California.txt"
EUS = "countries/E-Eastern US.txt"
EPI = "countries/E-Eastern FPI.txt"
WPI = "countries/E-Western FPI.txt"
CAN = "countries/E-Canada.txt"
MEX = "countries/E-Mexico.txt"
KER = "countries/E-Kerfuffle.txt"
GEU = "countries/E-European Union.txt"

#Mewni
MEW = "countries/M-Butterfly Kingdom.txt"
JOH = "countries/M-Johansen Kingdom.txt"
BUF = "countries/M-Monster Buffer.txt"
PNY = "countries/M-Ponyhead Kingdom.txt"
SPI = "countries/M-Spiderbite Kingdom.txt"
PIG = "countries/M-Pigeon Kingdom.txt"
LUC = "countries/M-Lucitor Kingdom.txt"
JAG = "countries/M-Jaggy Kingdom.txt"
PIE = "countries/M-Pie Folk.txt"
LUD = "countries/M-Ludo's Kingdom.txt"
CEF = "countries/EM-CEF_PORT.txt"

#Mewni_Monsters
OST = "countries/Monst-ostritch-starvary.txt"
ICH = "countries/Monst-Itchy Kingdom.txt"
AIR = "countries/Monst-Lordship of the Air.txt"
MMG = "countries/Monst-The Monsters Merchant Guild.txt"
JUN = "countries/Monst-Restoration Junta.txt"
REP = "countries/Monst-Republic of the Tri River.txt"
HKM = "countries/Monst-Holy Kingdom of Musty Mountain.txt"
STI = "countries/Monst-Warlordship of the River Sticks.txt"
MER = "countries/Monst-Mercanaries of the Hell Coast.txt"
SOL = "countries/Monst-Solarian Cleansing State of the Underworld.txt"
UKN = "countries/Monst-anarch-Unknown.txt"
SCU = "countries/Monst-Scout Team 227.txt"
SIG = "countries/Monst-Sigma State.txt"
SPK = "countries/Monst-Spiked Angels.txt"

#Mewni_North_Monsters
SWP = "countries/N-Monst-Coalition of the Swamp.txt"
TSR = "countries/N-Monst-Tsardom.txt"
KAI = "countries/N-Monst-Kaiserreich.txt"
AVA = "countries/N-Monst-Avarius Exile.txt"
DTH = "countries/N-monst death cult.txt"
HGH = "countries/N-monst forest high.txt"
DRG = "countries/N-monst drug empire.txt"
MHC = "countries/M-Magic High Commision Peacekeeping.txt"
MW1 = "countries/N-monst 1.txt"
MW2 = "countries/N-monst 2.txt"
MW3 = "countries/N-monst 3.txt"
MW4 = "countries/N-monst 4.txt"
MW5 = "countries/N-monst 5.txt"
MW6 = "countries/N-monst 6.txt"

#US States 
ARZ = "countries/US-Arizona.txt"
ARK = "countries/US-Arkansas.txt"
CRD = "countries/US-Colorado.txt"
IDH = "countries/US-Idaho.txt"
IWA = "countries/US-Iowa.txt"
KAN = "countries/US-Kansas.txt"
LOU = "countries/US-Louisiana.txt"
MIN = "countries/US-Minnesota.txt"
MIS = "countries/US-Missouri.txt"
MON = "countries/US-Montana.txt"
NEB = "countries/US-Nebraska.txt"
NEV = "countries/US-Nevada.txt"
NMX = "countries/US-New Mexico.txt"
NDK = "countries/US-North Dakota.txt"
OKL = "countries/US-Oklahoma.txt"
SDK = "countries/US-South Dakota.txt"
TEX = "countries/US-Texas.txt"
UTH = "countries/US-Utah.txt"
WYM = "countries/US-Wyoming.txt"
CIA = "countries/E-Gang of Four.txt"
COG = "countries/E-Cognito Inc.txt"

#Amphibia
AMP = "countries/A-Amphibia.txt"
WRT = "countries/A-Wartwood.txt"

#Boiling Isles
BOI = "countries/BI-Emperor Coven.txt"
BON = "countries/BI-Bonesborough.txt"
OWL = "countries/BI-The Owl House.txt"
COM = "countries/BI-Conformatorium.txt"
ILL = "countries/BI-Illusion Coven.txt"
CST = "countries/BI-Construction Coven.txt"
POT = "countries/BI-Potions Coven.txt"
PLA = "countries/BI-Plants Coven.txt"
BAR = "countries/BI-Bard Coven.txt"
BEA = "countries/BI-Beast Coven.txt"
ORA = "countries/BI-Oracle Coven.txt"
HEA = "countries/BI-Healing Coven.txt"
ABO = "countries/BI-Abomination Coven.txt"



#Dimensional Barriers
ROM = "countries/D-Barrier.txt"
WAL = "countries/D-Realm of Magic.txt"
ZZZ = "countries/D-Classified.txt"
